21
15
WWWWWWWWWWWWWWWWWWWWW
WPFRRRRRRRRRRRRRRRFFW
WFWRWRWRWRWRWRWRWRWFW
WRRRRRRRRRRRRRRRRRRRW
WRWRWRWRWRWRWRWRWRWRW
WRRRRRRRRRRRRRRRRRRRW
WRWRWRWRWRWRWRWRWRWRW
WRRRRRRRRRRRRRRRRRRRW
WRWRWRWRWRWRWRWRWRWRW
WRRRRRRRRRRRRRRRRRRRW
WRWRWRWRWRWRWRWRWRWRW
WRRRRRRRRRRRRRRRRRRRW
WFWRWRWRWRWRWRWRWRWFW
WFFRRRRRRRRRRRRRRRFEW
WWWWWWWWWWWWWWWWWWWWW